{
  "2": "ء",
  "3": "ع",
  "3'": "غ",
  "5": "خ",
  "6": "ط",
  "6'": "ظ",
  "7": "ح",
  "8": "ق",
  "9": "ص",
  "9'": "ض",
  "a": "ا",
  "b": "ب",
  "t": "ت",
  "th": "ث",
  "j": "ج",
  "ch": "تش",
  "h": "ه",
  "kh": "خ",
  "d": "د",
  "dh": "ذ",
  "r": "ر",
  "z": "ز",
  "s": "س",
  "sh": "ش",
  "f": "ف",
  "q": "ق",
  "k": "ك",
  "l": "ل",
  "m": "م",
  "n": "ن",
  "w": "و",
  "y": "ي",
  "e": "ي",
  "i": "ي",
  "o": "و",
  "u": "و"
}